NO textures/north.png
SO textures/south.png
WE textures/west.png
EA textures/east.png
F  0,255,0
C  50,0,120
11111111111111111
100000W0001000001
1000000000DX00001
11111111111111111